{
    "name": "Civyshk Line5",
    "size": {"r": 15, "c": 10},
    "path": [
        {"r": 0, "c": -1},
        {"r": 0, "c": 0},
        {"r": 0, "c": 1},
        {"r": 1, "c": 1},
        {"r": 2, "c": 1},
        {"r": 3, "c": 1},
        {"r": 4, "c": 1},
        {"r": 5, "c": 1},
        {"r": 6, "c": 1},
        {"r": 7, "c": 1},
        {"r": 8, "c": 1},
        {"r": 9, "c": 1},
        {"r": 10, "c": 1},
        {"r": 10, "c": 2},
        {"r": 10, "c": 3},
        {"r": 9, "c": 3},
        {"r": 8, "c": 3},
        {"r": 7, "c": 3},
        {"r": 6, "c": 3},
        {"r": 5, "c": 3},
        {"r": 4, "c": 3},
        {"r": 3, "c": 3},
        {"r": 2, "c": 3},
        {"r": 1, "c": 3},
        {"r": 1, "c": 4},
        {"r": 1, "c": 5},
        {"r": 2, "c": 5},
        {"r": 3, "c": 5},
        {"r": 4, "c": 5},
        {"r": 5, "c": 5},
        {"r": 6, "c": 5},
        {"r": 7, "c": 5},
        {"r": 8, "c": 5},
        {"r": 9, "c": 5},
        {"r": 10, "c": 5},
        {"r": 10, "c": 6},
        {"r": 10, "c": 7},
        {"r": 9, "c": 7},
        {"r": 8, "c": 7},
        {"r": 7, "c": 7},
        {"r": 6, "c": 7},
        {"r": 5, "c": 7},
        {"r": 4, "c": 7},
        {"r": 3, "c": 7},
        {"r": 2, "c": 7},
        {"r": 1, "c": 7},
        {"r": 1, "c": 8},
        {"r": 1, "c": 9},
        {"r": 2, "c": 9},
        {"r": 3, "c": 9},
        {"r": 4, "c": 9},
        {"r": 5, "c": 9},
        {"r": 6, "c": 9},
        {"r": 7, "c": 9},
        {"r": 8, "c": 9},
        {"r": 9, "c": 9},
        {"r": 10, "c": 9},
        {"r": 11, "c": 9},
        {"r": 12, "c": 9},
        {"r": 12, "c": 8},
        {"r": 13, "c": 8},
        {"r": 14, "c": 8},
        {"r": 14, "c": 9},
        {"r": 14, "c": 10}
    ],
    "plateaus": []
}