{
    "name": "Civyshk 2Y",
    "size": {"r": 15, "c": 10},
    "path": [
        {"r": -1, "c": 6},
        {"r": 0, "c": 6},
        {"r": 1, "c": 6},
        {"r": 2, "c": 6},
        {"r": 2, "c": 5},
        {"r": 2, "c": 4},
        {"r": 1, "c": 4},
        {"r": 1, "c": 3},
        {"r": 1, "c": 2},
        {"r": 1, "c": 1},
        {"r": 1, "c": 0},
        {"r": 2, "c": 0},
        {"r": 3, "c": 0},
        {"r": 4, "c": 0},
        {"r": 5, "c": 0},
        {"r": 6, "c": 0},
        {"r": 7, "c": 0},
        {"r": 7, "c": 1},
        {"r": 7, "c": 2},
        {"r": 6, "c": 2},
        {"r": 5, "c": 2},
        {"r": 4, "c": 2},
        {"r": 4, "c": 3},
        {"r": 4, "c": 4},
        {"r": 5, "c": 4},
        {"r": 6, "c": 4},
        {"r": 7, "c": 4},
        {"r": 8, "c": 4},
        {"r": 9, "c": 4},
        {"r": 9, "c": 3},
        {"r": 9, "c": 2},
        {"r": 9, "c": 1},
        {"r": 10, "c": 1},
        {"r": 11, "c": 1},
        {"r": 11, "c": 2},
        {"r": 11, "c": 3},
        {"r": 11, "c": 4},
        {"r": 12, "c": 4},
        {"r": 13, "c": 4},
        {"r": 13, "c": 5},
        {"r": 13, "c": 6},
        {"r": 13, "c": 7},
        {"r": 13, "c": 8},
        {"r": 12, "c": 8},
        {"r": 11, "c": 8},
        {"r": 11, "c": 7},
        {"r": 11, "c": 6},
        {"r": 10, "c": 6},
        {"r": 9, "c": 6},
        {"r": 9, "c": 7},
        {"r": 9, "c": 8},
        {"r": 8, "c": 8},
        {"r": 7, "c": 8},
        {"r": 7, "c": 7},
        {"r": 7, "c": 6},
        {"r": 6, "c": 6},
        {"r": 5, "c": 6},
        {"r": 4, "c": 6},
        {"r": 4, "c": 7},
        {"r": 4, "c": 8},
        {"r": 3, "c": 8},
        {"r": 2, "c": 8},
        {"r": 1, "c": 8},
        {"r": 0, "c": 8},
        {"r": -1, "c": 8}
    ],
    "plateaus": []
}