{
    "name": "Civyshk Labyrinth",
    "size": {"r": 15, "c": 7},
    "path": [
        {"r": -1, "c": 1},
        {"r": 0, "c": 1},
        {"r": 1, "c": 1},
        {"r": 2, "c": 1},
        {"r": 3, "c": 1},
        {"r": 4, "c": 1},
        {"r": 5, "c": 1},
        {"r": 6, "c": 1},
        {"r": 7, "c": 1},
        {"r": 8, "c": 1},
        {"r": 8, "c": 2},
        {"r": 8, "c": 3},
        {"r": 9, "c": 3},
        {"r": 10, "c": 3},
        {"r": 10, "c": 2},
        {"r": 11, "c": 2},
        {"r": 12, "c": 2},
        {"r": 13, "c": 2},
        {"r": 13, "c": 1},
        {"r": 13, "c": 2},
        {"r": 12, "c": 2},
        {"r": 11, "c": 2},
        {"r": 10, "c": 2},
        {"r": 10, "c": 3},
        {"r": 9, "c": 3},
        {"r": 8, "c": 3},
        {"r": 7, "c": 3},
        {"r": 6, "c": 3},
        {"r": 5, "c": 3},
        {"r": 4, "c": 3},
        {"r": 4, "c": 4},
        {"r": 3, "c": 4},
        {"r": 2, "c": 4},
        {"r": 1, "c": 4},
        {"r": 1, "c": 5},
        {"r": 1, "c": 4},
        {"r": 2, "c": 4},
        {"r": 3, "c": 4},
        {"r": 4, "c": 4},
        {"r": 4, "c": 3},
        {"r": 5, "c": 3},
        {"r": 6, "c": 3},
        {"r": 6, "c": 4},
        {"r": 6, "c": 5},
        {"r": 7, "c": 5},
        {"r": 8, "c": 5},
        {"r": 9, "c": 5},
        {"r": 10, "c": 5},
        {"r": 11, "c": 5},
        {"r": 12, "c": 5},
        {"r": 13, "c": 5},
        {"r": 14, "c": 5},
        {"r": 15, "c": 5}
    ],
    "plateaus": []
}